sent	label
Reminder for daily reporting and attendance on mob app daily 9:00 am	Found
How will you remind me let me know	Not Found
Can u remind me till 11	Found
Call at 9 am every day	Not Found
Remind me to bid for flights on 13th december at 6 pm	Found
Reminder 11am tomorrorw buy bell for papu	Found
Remind me to book b tickets tonight by 10 pm	Found
Can you remind me to masturbate	Not Found
Reminder on invoice preparation	Found
1 alarm at 1 30am please. Ignore the 12 20am one	Found
One more reminder....2:00 pm ...today for meeting	Found
call sagar @5:30 pm	Found
I'm upset vth d reminder service	Found
Remind me to see. Concert at 7pm	Found
Remind me again after half an hour	Found
Need a reminder for payment and phone at 2pm	Found
Remind me tomorrow 11 am to pack gift for my college sir.	Found
Remind me on 1st dec to take appointment of those 2 customer at sanaswadi	Found
Remind me to play football at 10 5	Found
Weke up alarm I need morning	Found
Would you remind me to print the log sheet out today	Found
Cud u pls set up a recuring reminder	Found
Hey thanks for ur reminder	Found
Please remind me every Tuesday n Thursday for a meeting at Chopras, at 11 am	Found
Yes.. I'll surely use it.. When I need u to remind me something! Thank you	Not Found
Make it a everyday schedule	Found
What an early reminder?	Found
Remind me to pray daily at noon	Found
Okk	Not Found
Remind me of talking with RICS TODAY AT 11 AM ,	Found
Please set this for complete month	Found
1 jan 11.55	Found
Remind me to take my friend's car for wash on 12th before she comes back	Found
Remind me next month 16th for hepatitis B vaccination at 10am	Not Found
hieee	Not Found
Remind me to attend reception of Kishor Bhai's Son on 28th November	Found
Manali sir reminder aata nhi hai	Found
Cancl	Not Found
Thank you Sachin for your reminder...ðŸ˜Š	Not Found
Reminder me to take print out	Found
I have to add reminder	Found
Remind me to renew my insurance of car on 20/11/2017	Found
Can the reminder be for 365 days?	Found
Call means what?	Not Found
Hey good morning	Found
Plz remind me to go to the gym at 9am	Found
Instead of 5 remind me at 5:30	Not Found
OK Tomo I want a reminder to b set	Found
I want to be set	Found
Plz remind ne	Found
Hey thanks. Reminder for what exactly?	Found
Hie can u remind me to finish Eis audit by 10 January	Found
Remaind for dinner at 7:08 on today	Not Found
It's ok... I'll let you know if I need any help	Not Found
Remind me from daily from today	Found
Please remind me to take a test at 4:30 pm tomorrow.	Found
Then remind me for studying at 3:30 pm	Found
Remind me to do my studies	Found
What is the reminder?	Found
Tell me something about haptik	Not Found
Remind me at 830 today - to carry S C O solution home	Found
Basket saaf krni h....remind me on 8 PM tomorrow	Found
what is the exam timing of bharatiya vidya bhavans clg churchgate for fyba today	Found
Reminder me at 9.00 am	Found
I want to meet my boss at around 3pm. So remind me about it at around 12	Found
Can you call me @ 8106683849	Not Found
Thx for reminder	Found
Please remind me after 2 .00 pm for today	Found
Remind me to watch star gold @9 pm	Found
Need reminder	Found
I need to change that reminder	Found
Close all the remainder	Found
Remind me to collect laptop bill NOC from bajaj finance on 10 march	Found
Do I have any reminders active for me??	Found
10:15 am	Not Found
there are legal matters for which i need to be present in court for... need to make different reminders	Found
Plz remind me go to home nd teck beg	Found
Please remind me at 8 am	Found
just set a call and notification reminder	Found
HI !!! Could you please set an alarm of 6:00 pm	Found
Can you please put my reminder in notifications of my mobile	Found
Can you please remind me for a vaccination at 8:30 pm.	Found
Can you remind me that I have to send my PPF form and details today. Secondly that I need to book my transit flight to Malaysia	Found
Remind me at 9 ,i gotta take drugs	Found
Can u schedule one more for me?	Not Found
Pls remind to mail to Shailendra by 11 pm today	Found
Also remind me of wrapping the gift for Samiran at 08:45	Found
Setup reminder	Found
Hi please remind me to go to doctor on 10th December at 12.30	Found
I want to delete all the reminders set till today	Found
Please remind me after 5 days to close the Lynda.com site	Found
Hi. Remind me everyday at 10pm to brush my teeth nd sleep	Found
Can u remember me for tablets at 12 at night	Found
Can you set me alarms	Not Found
Remind me to talk to ZEROGRAVITY ppl	Found
ReMind me	Not Found
And set a snooze for 4:30 am also	Not Found
Ya one more reminder	Found
The same u shud remind me every day	Found
Also remind me to get my bike insured at 11 am tommorow	Found
Remind me to book bus tickets	Found
You can remind me at 3.50am	Not Found
Can u remind me to study at 10:00 pm	Found
Change the reminder to 8:00 am	Found
Remind me booking cover my love	Found
Remind me i have to pay Lakshya 500 rupees	Found
Reminder me at 7.25	Found
Can you remind me about one more thing?	Found
Remind me at 11 am to do my PE project	Found
Can you remind me about my Books at 9:50 am	Found
Remind me to finishmy snap registration	Found
Do I need to enable the reminder gain and again	Found
Remind me to send a mail to Pooja bajaj at 9 in the night	Found
And set 2 remainder also	Found
Can you set an reminder for me?	Not Found
I would need you to remind me of some action items	Not Found
Remind me about NGO	Not Found
Pls tell me more about haptik	Found
8 AM	Not Found
Thanks i received a call	Found
Set the schedule	Found
Remind me in six months	Found
Another reminder for making a transfer certificate for vihaan	Not Found
Business meeting to Chitradurga on 23 Nov 2016	Found
Set this reminder on 902109077	Found
Remind me to buy eggs at 9:11 pm today	Found
8th may 12 o clock	Found
Need to set one more alarm	Found
remind about mastrubating	Not Found
Remind me at 9:15p.m. today on 23 december 2016	Found
Dint get the reminder last time	Found
Hello Gloria!	Found
Wish Birthday Name: Rashmitha Date: April 14, 2017 Time: 11 55 pm	Found
10 December	Not Found
This one remind me to get the box from my friend's place.	Found
Remind me for my leave plan for Jan	Not Found
263/pw/10 Pl remind on 6/2/17	Found
remind me tommorow to fill my loan application	Found
Just remind me to go outside at 4:00 pm	Found
Remind on 22 nov	Found
Hi can u please remind me about time end of newspaper	Found
I need a reminder for November 2017	Not Found
Thanks for this awesome reminder ðŸ˜Š	Found
Remind me of vedant appointment cardiologist at 11 am on21 november	Not Found
Can you tell how to set dnd	Found
remind me to wish chiriya	Found
Remind me to attend Yashraj's engagement	Found
Remind me my lpg Botel booking	Found
Remind me to buy excel matic today @ 8.00 pm	Found
Pls remind me to attend marriage on 21 January 9 am of Patel at keshavbag party plot	Found
Can u pls set an alarm for 8 in the morning for tomorrow	Found
Remind me on 7th January at 8 pm for TV program	Found
Hi Good Morning .. Thanks for this assistance... Yes pls help me out with to do list	Found
Old remember and this same	Found
Hey can you remind me every 1 hour from 8am to 12 pm everday?	Found
Sure i will aftr wkeup call	Not Found
Remind me to pack for my college by tomorrow 5pm	Found
I am done with my schedule	Found
Remind me about it rectification	Found
Amd please remind me to do microbial metabolism at 11am today	Found
Just remind me every 1 of every month	Not Found
Today 745 am, pl remind me about serahs birth certificate	Not Found
tell me about this	Found
Remind me for Monday's interview with govt of India	Found
Plz remind me only in afternoon	Found
Thank u soooo much for reminding me ðŸ˜˜ðŸ˜˜ðŸ˜˜	Found
OK ! I am about to do it !	Found
Abhi tho remind kiya dhas minute ke pehle ðŸ˜‚	Found
Everyday reminder	Found
Three alarms	Not Found
Also.. Plz remind me to collect diary from shop tomorow at 7.30 pm	Found
Hey, could you remind me to wish mom on 12th dec, say 8.30 AM	Found
Remind me for recharge	Not Found
Please remind me about my bike service to be given on 28 th of thismonth.	Found
Plz remind every year	Found
Please set a general reminder every hour .please call	Found
Can you Please set a reminder for tomorrow	Not Found
Please set a reminder	Found
Can I get two calls?!	Found
Also I need to deposit 20K in my savings account for recurring deposit on 20th, please remind me on 19th at 10am	Found
Plz set a reminder to watch channel	Found
Hey sis do remind me on 11th of Jan..1 more to go 4 Amitesh birthday	Found
Can I plz make this reminder for whole week....	Found
Pl remind today at 8 pm to keep blanl cheque	Found
What was my reminder of today 10 am	Found
Mere 2no reminder active hai ?	Found
Remind me to eat egg at 5:45 PM today.	Found
Shraddha another one reminder please can you do this?	Found
Plz remind me about today's tasks????	Found
Ok please send me the reminder	Found
Give me a reminder to send mail by 10:40 now	Found
So WL u b available 24x7 means if i set a reminder late night thn?	Found
Deactivate reminder	Found
Remind me to collect collect the brail from the blind school on 14	Found
Why i have a call from haptik?	Found
Remind me to take bath at 12:30 Today	Found
Remind me of pavan cheated upon james	Found
Please deactivate all alarms	Found
Is it possible to remind me everyday?	Found
Can u set reminder for me !	Found
Only reminder	Found
Could you please remind me to keep the money in kitchen tomorrow at around 10:40am	Found
Need another reminder to set	Found
Ok thanks for remember	Found
Please message me instead of calling	Found
18dec 12:00 pm schedule Pintu didi lunch	Found
Please tell us about haptik software	Found
1.30 pm Reminder: shankar test	Found
There were some of my reminders for this month on other phone and now I have a just changed	Found
8.00 am	Not Found
Your reminder is 1 day reminder	Found
Alarms after 8 pm also needed	Found
This is tomorrow's study schedule	Found
Pls make sure all my reminder r with the content	Found
thx for reminding	Found
Yes.....i want u to remind me that every day	Found
Remind me to send my wife a gift	Found
Sorry . Got a little late. Will schedule my tasks later.	Found
Reminder after 15 min	Found
Remind me on 10th Dec morning 4am to take gold flower's and bro mariage clothes..	Found
Remind me to uninstall you	Not Found
Also remind me to check harish's computer.	Found
Rahulji HI calling at 7pm today 7891044451	Found
Can u give a fake call	Found
I have got 1 more reminder	Found
Thanks for reminding me	Found
Reminder Appointment for driving licenses	Found
Please remind me to repair my wife's phone at 10am tomorrow	Found
Actually set a alarm for 5 tomorrow morning .	Not Found
Yup! Tysm for reminder...ðŸ˜‡ðŸ˜ƒ	Found
Set 10 am to 10 pm	Found
Can u like play a song rather than calling	Found
Remind me tomorrow for visiting new house	Not Found
Date: November 21, 2016 Time: 12 30 PM	Found
Sorry please make it 8.45 pm for Reminder	Found
Set a reminder at 8 am as well	Found
Remind me after another half an hour	Found
Remind me to check a website in two days	Found
Sould i have to recieve the call??	Found
Can you just send me reminders through SMS?	Found
Reminder on Monday at 11 am to go to guru Ji	Found
I need a call at that time	Not Found
Coll me to remind	Found
Can u plz remind me the same tomorrow at 2pm	Found
3 reminders please	Found
I need an alarm	Found
Can you set an alarm at 9 pm	Found
Can you tell me if i have any reminders set?	Not Found
Plz remind from 8:00 am to 10:00 pm	Found
Also remind me to cal Daya handloom on 16-11-2016 at 11:30am	Found
Can you please remind me tomorrow at 9pm to start research work	Found
Reminder was set up at 6	Found
Remind me abt tuition at 8:15	Found
I need to set a reminder	Found
Shave and carry shaving kit reminder tomorrow at 815 am and again at 830 am	Found
Reminder.. In the morning by 9:30a.m to check out Vodafone bill payment	Found
Remind me at 7 pm today for massage	Not Found
Remind me at 8.45 am today	Found
Set a reminder for 1.20 pm	Found
Remind me about take a test at 9 am	Found
Will you call me even if iam online on haptik	Not Found
Please set a reminder for 5th jan 17 for to ask ritika for balance confirmation circularisation	Found
Remind me to get some info about dentistry... Tomorrow 11 am	Found
Remind me on 7 Nov 12pm for Venus payment.	Found
Remind me about diwo today @5pm	Found
Hi. Remind me at 2:45pm today to leave for driving class	Found
Set alarm at 6:15am	Found
By call??	Not Found
Set a reminder on Thursday and Friday at 7 and 8 pm	Found
Friday evening 6o clock make a reminder of reminding chetan sir for the gift	Found
Reminder me for IAS application form	Found
Hi..remind me of sending important message to my teacher at 4:30pm	Found
Also Reminde me to cal maruti	Found
Tell me one thing I'm just lit bit curious about reminder call..	Found
Set reminder for raising travel request	Found
Gm	Not Found
I want to set time myself	Not Found
Reminder? For what?	Not Found
Please remind to process hyderabad rent payment tomorrow 4pm	Found
I want a reminder to catch a flight tomorrow at 6pm	Found
Remind me at 12 noon	Found
Remind me to shop in myntra tomorrow	Found
Two call with 15 min intervel	Found
Remind me to tell him abt job preferences at Pune and get advice	Found
Please would you remind me at 9:40 pm	Found
The reminder should be at 1215	Found
Yeah...but can you schedule it from sunfay	Found
Movie schedule for Sunday at inox Panajim	Not Found
I got reminder now	Found
Good morning Naqiyya	Found
Remind that ppt today 6.00pm	Found
Is there a reminder tone	Found
Call Deepak on 9 A.M tomorrow	Found
Reminder to give money back to vel	Found
i want sms reminder every 1 hour 2 min..... from 8:00 pm	Found
I want to set up reminder	Found
Call me at 6.30am	Found
Set me a reminder to wish my friend birthday on 10th December	Found
Remind me at 2:30 pm that it's 27%	Found
Why general? I need specific reminder with the task discription	Found
Remind me to go to movie dangal at 7pm	Found
Do you know what to remind me about	Found
Could u pls set a reminder for me	Found
Remind me to message ANIL PIE on 27th morning at 10:00 am	Found
Can u tell me something about u?ðŸ˜œ	Not Found
Visit puma store reminder at 630pm today	Found
Can you please give a call around 4 .30 pm IST	Found
Reminde me aftr 1 hour	Found
Do we need internet for Marvel Future fight.	Found
Could you please remind me for wish my friend for birthday.... today at 9am	Found
set a reminder for me	Not Found
Remind me today at 11 pm about sarkari noukari	Found
Oh yes! But right now there is nothing that I would like to be reminded about.. I will let you know if I need.	Found
Remind me to to go to Austria on 3 march	Found
Thank u	Found
1/2 tab of Stamlobeta at 9.30 AM, Ecospirin 150 mg by 2.00 PM and Tonact 40mg by 9.30 PM	Found
6am	Not Found
thanks for the remainder	Found
Remains Me about going to Yusof home on 9.30 am	Found
And please remind me at sharp 8:30	Found
Ok thnx for reminding me	Found
Change my self study remainder from 12:00 pm to 10:15 am	Found
Remind me of gng to Suhas Arc by 12	Found
Hi samreen remind me to have a walk per one hour	Found
Please set reminder for 9 pm to pay lic premium	Found
Please remind me at 5:45	Found
I want the reminder from 10 am till 8 pm in the night at the interval of 1 hour	Found
Remind me at 2:42 pm today	Found
Reminder fr gym	Found
Remind me with notification	Found
Wish Birthday Name: Archana Atrawalkar Date: January 23, 2017 Time: 8 00 am	Found
Thnx 2 remind me	Found
Remind me of calling at vyas classes tomorrow at 10.30 am	Found
Remind me evening time provide some data to a person	Found
Today 7pm remind to go to see office	Found
Can you remind me for	Not Found
Remind me to book train ticket at 1030	Found
A reminder a 7 pm as well	Found
Add alarm	Not Found
Could you please remind me for on January 7 for watching sherlock holmes season 4 on axn	Found
Set a reminder at 1.00 pm to get ready for class	Found
Pleade tell me about alto and wagonR	Found
Remind me to go to bhagyashrees place @8:20	Found
Can u remind somebody else too on my behalf?	Found
Put up a general reminder for "form omkar" at 8:30am tomorrow	Found
If I m offline then also u reminds me	Found
Remind me of reading newspaper loudly	Not Found
But how to indicate which schedule is this	Found
7:00 am	Not Found
Ring *	Not Found
Yes I would like you to remind me everyday starting from tomorrow	Found
Who is better? Sir Dhruneal or Mr. Doshi?	Found
How to manage reminders	Found
Dismissed schedule.	Not Found
Set reminder for today on 7.20pm	Found
Can u plz remind me for a webinar at 4pm today	Found
Reminder for Sunday 15 Jan birthday party for friend 's daughter	Found
Set reminder for 9:45am 9:50am, 9:55 am, 10:00 am, 10:05 am tomorrow	Found
Will u ring	Not Found
On 2 Jan around 9pm	Found
I want a reminder every Friday by 9:00 pm that I have practicals on Saturday	Found
Actually I have to email them. Remind me please	Found
So how you will remind me.	Not Found
Remind me at 2.30 pm today for NRI account.	Not Found
Sory Sory..unknowingly I pressed it again..jus one reminder is enuf	Found
Can u help me remind my boyfriends birthday whc is on 22dec	Found
Set Alarm from 4:40AM to 5:00AM, today, 5 minutes difference	Found
Remind me at 11.55am about lenovo fab sell on Flipkart	Found
Can you remind me to send an email to Raghu tomorrow morning @ 10am	Found
Call me at 6 am and 6.40 am on 11 nobember	Found
5 am	Not Found
Remind me tomorrow at 2 pm SBI CC bill payment	Found
Remind me to charge battery at 8 am tomorrow	Found
Thanks...for reminding me	Found
Remind me to pay rs 3500 to depak	Found
Keep reminding me of studying hard. Tell me everytime that I have to be a Good Doctor.	Found
CAn u pls dismiss this reminder	Found
Set Alarm from 4:40AM to 5:00AM, today, 2 minutes difference	Found
Calling tomorrow rakesh kumar Jain at 12:30 pm	Found
Remind me at 9pm today. I need to fill a forn	Found
Nope! Thank u for reminding	Found
Remind me onthis 9th to do recharge	Found
Remind me to make a presentation by 10am for debreif Spain trip	Found
Hi, pls change the reminders frequency to every 3 hours from the current frequency of 2 hrs	Found
I need this reminder every Saturday at the same time	Found
Tata sky recharge remind me on 7th Jan at 3 clock	Found
Schedule to meet imran by 9 30pm today	Found
I want to add one more b'day reminder	Found
And what should go on my to-do list?	Found
i would like this reminder every day	Found
Iam little bit lazy so u can set one more alarm of 8 15am?	Found
Call sanjay, rajesh today by 4 pm	Found
Remind me to buy book tomorro at 8:00 am	Found
Would like to set one more reminder	Found
Remind me to take print out of my flight tickets	Found
Remind me to go to washroom at 3am	Found
Remind me in 2:00pm clock	Found
For both the reminders	Found
I want one reminder	Found
Plz remind me for booking of Train ticket today at 10:45	Found
I m getting irrigating from lot of calls from haptik	Found
I can remember now by my own	Found
Pls set an alarm for 8 am	Found
Remind me to have sex with my girlfriend in two minutes	Found
Remind me at 4pm today to work on education	Found
Remind me today at 1:40 pm for scooper	Found
Morning. Thanks for the reminder....have a great day	Found
Remind m tom at 11 to cal prof meena	Found
Can you remind me to do German assignments tomorrow please ?	Found
Remind me at 3 pm	Found
Thanks for this call	Found
It would be helpful if you could remind me to leave 45 minutes in advance, as I am leaving from Gurugram to Saket.	Found
Remind me @ 2.30pm today	Not Found
Thanks... m about to have!	Found
Set a reminder of bathing	Found
Thanks for the reminder Karan! :)	Found
Remind me that i have to whatsapp manju aunty	Found
Any alarm tone?	Not Found
Pls remind me to get 2 passport size photo for adhaar work.	Found
Do u remember me	Found
please remind me after 2 hrs	Found
You remind me at 6 pm 4 jan	Not Found
Been busy, sorry about that.	Found
Hii remind me to download the splendid app	Found
Can you help me with weekly reminders of reading something	Not Found
Remember its really important for me .	Not Found
I need a reminder on 10 June 2017 about shilpi birthday	Found
Remind me to go office at 12. 30 pm tomorrow	Found
Can you remind me to send quote for incastt machines	Not Found
Remind me to go to post office on 12th Jan 2017 at 9 am	Found
Please set up 2nd alarm also for me	Found
I need repeat alarm in next 5 mins	Found
Remind me to take the tickets on 18th January 2017 at 3 pm. Thank you.	Found
Remind me the same in an hour please	Found
Set it to till 9 pm	Found
Thanks Mahesh for reminder	Found
Icon finder reminder still pending on 1st of the month	Found
please remind the above tomorrow at same time	Found
I need regular to remind me	Found
Remind me for KEB bill	Not Found
Can you remind me to take my food from the fridge tomorrow	Found
Set reminder foe 1.45 pm today	Found
Tommorow 1 pm Reminder	Found
Could you set it till 12 am?	Found
Can you please help me create a schedule for the days	Not Found
Set remi der after 10 min	Found
I changed my number so I need all my remainders to be sent to my new number..is that possible	Found
Set a reminder for xrd slot on friday	Found
Can u set a reminder for the 3rd of feb	Found
Jai jinendra Thnx shrdha ji for my today schedule	Found
Remind me to write the question paper in the morning	Found
Who kept alarm at this time shardha	Found
Hey Ples Remind me pop drawing and vanity drg At 1pm	Found
Just remind me to collect books at 12:30	Found
Remind me tomorrow to collect my marks cards.	Found
Another 2 alarms at 8:00am , 8:20am also... Plz	Found
I know very well about ur haptik how to use but when to use i will decide	Found
Remind tomorrow at 11 am about talking to bindu n shiv about the customer complaint.	Found
make medic reminder at 11.30 am	Found
Set an alarm at 7:30 pm today.	Found
Remind me that I should get ready early tomorrow and go to temple in the morning	Found
Give me a call @ 8 pm...	Found
Remind me to type report at 9 pm today	Found
Can you please adjust the schedule	Not Found
Remind me to deposit PPF amount at 3 pm today	Found
Plz remind me before every match	Found
Can u set this every day	Found
Hi	Not Found
Remind me to take puneet construction brief at 12pm	Found
Set reminder for insurance payment on 15th February	Found
Remind me to go to bank today at 3:00 PM	Found
Can you change my reminders	Found
Remind me tommorow in morning about my summer training report file submission	Found
Remind me on 18th jan 2 atttend seminar dated 19th jan Thursday	Found
Can you change the reminder time for tommorow s meeting to 9.30 ?	Found
Remind me to buy Gehu today at 1pm	Found
why havent uh called me up for my alarm	Found
Remind me to take my lab coat at tomorrow morning 8 am	Found
Set at 8:30	Not Found
, Agar Mujhe Pani Peene Ke Liye Koi reminder set karo	Found
Kindly reschedule the alarm for 7 am	Found
Thankyou for the reminder.	Found
Call to srinath at 2om	Found
Tmrw I go to church at 11.30 pm. Create a schedule	Found
Remind me on 13th Jan to meet mr Saboo next day	Found
Yeah can i pick up that call...and will some one please say good morning mick have a nice day	Found
ILC remainder	Found
Can u remember me about to atten alluminai on 3 rd December 9.00 clock am	Found
Deactivate all my alarms and reminders.	Found
Set reminder at 6 pm tomorrow to go driving classes	Found
Hi.. there is a change in schedule.	Found
Dish Tv recharge reminder set karna hai	Found
I wana set reminder	Found
Remind to pay 9009 to Vasanti textiles tomo at 12pm	Found
Remind me to take a cake home at 7pm today	Found
khushboo could you remind me to eat every 2.5 hours starting from 8am today?	Found
Oops need a reminder an hour bfr plz	Found
Can you please set me alarm	Not Found
Can you remind me today to wish tony stark a happy birthday	Found
Can you set reminder for my friend	Found
Reminder on 14th January 9:00 am	Found
Ok cn i get a nice song on d call	Found
9637521432	Not Found
What reminder?	Found
About what?	Not Found
Thanks for reminding all these while	Found
Please remind me this Saturday for shopp8ng	Found
Please set another reminder	Found
make a reminder for me	Not Found
Remind me to take a bath today at 10.45 am	Found
now set the birthday at 31st dec time 11:55	Found
Remind me at 11.52 for session	Not Found
Remind me to go to 'blue orange'	Found
Do you know any thing about karol darwaja delhi market?	Found
I had requested that reminder alerts be cancelled now	Found
Remind to book flight tickets on 1st Dec	Found
I want remainder	Not Found
ok so plz remind me evry 2 hours to stay me hydrate	Found
You sure I'll get a call?	Not Found
Thank you for calling me	Not Found
Can I set a daily remainder?	Found
Schedule it for all days of week	Found
Postpone the reminder to tomorrow	Found
U reminded me late though	Not Found
Set another remainder at 8 45	Found
Thanks for the reminder! Happy new year!!!!ðŸ˜ƒ	Found
Ok thanks	Found
Actually I need a reminder For everymonth 5th	Found
Remind me about asking definite integration	Not Found
Also remind me to complete the BMS OQ from my side at 4PM	Found
When you are reminding me.	Not Found
When is ankit birthday deepika	Found
Hi shruti,please set an alarm for 5:54 pm today..	Found
Could you remind to Submit IQN	Not Found
Pl.remind me 1) 1st of every month for putting fertilizer in the plants .... 2) 15th of every month for putting organic pesticide for plants.......	Found
REMIND ME TO WISH AAHELI ON 18th JANUARY	Found
Would you remind one of my friend too?	Found
Sir u remember me	Found
Remind me to make ShopCJ invoice	Found
Keep the reminders alive today. Thanks.	Found
Alarm in 2 hours	Not Found
Remind me nitrogen gas filling for car on 28/11/16 at 9am	Found
Can you remind me at 9.30Am to do yoga	Found
Can u set remainder Sayali for me	Not Found
Remind me to take my Vitamin D tablets every Friday, in the evening.	Found
Will u call and inform at the correct time	Not Found
Wrong reminder coming	Found
Would you remind me about flight	Not Found
Mam...can you just give me a reminder of tomorrow's tution at 8:15 am	Not Found
Can I set as repeatative?	Found
Can u remind me tomorrow at around 12 to pick up my things from the shop	Found
Hey! Can u remind me in every 2hour	Not Found
Today i need an reminder for buying bansuri and flag	Found
Can you save a reminder for me to play clash royale	Found
Remind me of meting on 27th November	Found
How will that reminder be??	Found
:)	Not Found
Remind me at 9 pm to day	Found
Set alarm for 8o'clock	Found
Remind me to take a shower at 12 45 pm	Found
Can u set an reminder	Found
Remind me in the next 30 minutes about the abovesaid task	Found
tomorrow at 11 am remind me to perder jockey tactel	Found
Pls change the reminder	Found
Please remind me on 1am for shutdown laptop	Found
Need a reminder 15mins before pls	Found
Add new reminder	Found
Plz make my schedule for tmw	Found
Hey ,can you remind me to Start reading chapter 9 in my book?	Found
Please remind me everyday for brush	Found
Good morning Pourush	Not Found
Can you remind me to right my diary everyday at 11:55 pm	Found
Remind me to study 7p's & second unit of BE tomorrow	Found
To remind ma'am about the class on 5th	Found
Bro I need study reminder daily is it possible	Found
Todays is Most importent in My life...... Want u to remind me every year	Found
I want to gift a cake to someone	Found
Hey, can you remind me to sleep at 4 PM today?	Found
Reminder today	Found
Remind me to go at Red Cross at 4:30pm in evening 25/11/2016	Found
Please set a reminder for me just after 20minutes wat the time is right now	Found
Remind to take cet material to cls @ 4 30 pm	Found
Can you remind me to go to photo studio for passport size photo. At 12:00pm today	Found
Remind me on 12 December	Found
Can u remind me that	Found
Remind me to pay my axis cc bill	Found
9327426063	Not Found
Okay..	Found
I want reminder every time when I get new Gmail	Not Found
Need an alarm at 7 PM today	Found
Please also remind me to walk every 25 mins	Found
For alarm i should on the net	Found
You faild to remind me on time, sad	Not Found
Is daily reminder available?	Found
Please set a reminder for me to book tatkal at 11.30 am tomorrow	Found
Can you connect all my friends list from Facebook and remind me accordingly.	Found
Thanks for calling!	Found
Is there any such facility that you guys keep calling till the time I answer	Found
remind me entire day today to register for courses	Not Found
ReMind me to bring bill book tomorrow	Found
Can you remind me d same thing at 5:00 pm tomorrow..?	Found
Remind me to say her to bring her ece copy in the colg	Found
One more thing can you please remind	Found
Please send other reminder details	Found
List of reminder	Found
To remind me	Found
Can you remind me to watch movie	Not Found
Remainder to eat fruit	Found
Thanks for remindering me	Not Found
Can you schedule a reminder	Not Found
Hey.. Can you give me a reminder at 1.57 for the next Mi shake shake game..	Not Found
I get reminder only when internet is ON	Found
Once again remind me at 8.35	Found
Remind me to attend caw 2:45 pm December 15	Found
Set a reminder for me	Not Found
How many times you are going to call me for the same	Found
I got to Skype with my friend at 8:30 pm can you please remind me that?	Found
Remind me to play guitar	Found
How will be the "call"?	Found
Bro	Found
Can you remind my wife tmrw to take her vitamin D injection at 3 pm	Found
I want to make reminder	Found
Reminder 2 being pomogranet tody at 5pm	Found
Maybe later..	Found
What about	Not Found
I need the reminder between 4 pm to 11 pm	Found
Remind me from tomorrow	Not Found
Ping me later jab m home	Found
Please end reminder	Found
I want reminders all day	Found
About to carry a ring for sivaswamy	Not Found
Details for which reminder?	Found
Remind to go for walk n yoga	Found
Remind me to come at 8 pm today	Found
Thanq. And remove(delete) all previous wakeup calls. Plz.	Found
Remind me too mail up my client	Found
Call ficci at 11 00 am tomorrow n thereafter call dme	Found
Remind me to wish vritz on her birthday which is on 11th november	Found
Take chakli from sachin reminder	Found
About Insurance refund	Found
Remind me to bring hair oil today	Found
I have a journey tomorrow night please remind me the same in the morning	Found
Please remind me to repair my laptop on Saturday I.e on 03-Dec-2016 at 9:30 AM	Found
Remind that maruti car insurance policy will come on Monday at 12 Tell dad about it	Found
I would like to set to do list reminder	Found
I am late to office	Not Found
2 calls	Not Found
Reminder to Marriage ceremony	Not Found
Remind me for my recharge	Found
Need to put in reminders for tom.	Found
Remind me tomorrow by 11 about baerlocher endorsements	Not Found
Remind me today at 1700hr to put fashion designer job requirement	Found
Remaind me for every 2 hours	Not Found
I want to set a new reminder	Found
Will i have two alarms	Not Found
K. Thank you so much for your remainder	Not Found
Did you set the target?	Not Found
Plz remind me again at 2:30	Found
Remind me at 9Pm to buy a fill for FM-2	Found
Tanushree... plz remind me at proper hour	Found
Can u please remind me to charge my phone at 3:30pm	Found
Heyya listen .... I need to know about something	Found
Just remind me to tune the channel of TV @ 9:00pm	Found
Do I have any reminder for today?	Found
Ya I know but remind me to go jacking ok	Found
Please close the reminder	Found
Remind me at 9 pm today of it return of Nextgen employee	Found
7:00	Not Found
Remind me to move cupboard today at 9:30pm	Found
Will discuss in evening	Not Found
set me an alarm on 8:00am on 28-12-16	Found
I already told about reminder of hr mantra app	Found
Hi gm	Not Found
Remind me to go to gym today at 5:34 pm	Found
can you suggest me the application for schedule silent mode n general mode	Found
What is the reminder I have set?	Found
U haven't called me right???	Found
N one more reminder I wanna set for 5:10am 26 december	Found
Can you please put this as a reminder for 7th dec 12pm again please	Found
Can you remind me to replace my lenses on 19th December	Found
set remider	Not Found
Remind me to keep the pass back at 2.00 pm tomorrow (19th November)	Found
Remind me bro bday at 11am today	Found
Remind me for economics notes at 2:50PM today	Found
Remind me to take a book for assinment today at 12:00 pm ok	Found
Set reminder on 5th December for visiting doctor on 6th December at Park clinic	Found
Repeat alarm at 8 am please	Found
And also remain me on Friday 10 am about medical bill	Found
Remind me same at 10.40pm today	Found
At least there should be notification popup because how would i get the reminder that i have to do something	Found
Remind me to ask simar to do 10 maths questions and learn square root table	Found
Also remind me to mail the presentation to Bloomberg tomorrow at 11 am	Found
Can u remind me on Monday at 1100 am to ask muthu on confirmation for the training	Found
Reminder for ticket booking	Found
Remind me tommorow to write jaasa uncle's 2000 rupees at 12 pm	Found
Can you remind me for tomorrow	Not Found
Set a reminder for 4pm also Medical check up	Found
i have problem with 11:58pm reminder please remoe it	Found
Reminder for study time	Not Found
Pls remind me to that I need to submit my documents tmw mng	Found
Okay thank you... That will be total 2 reminders is it?	Found
Please remind me to get ioning cloths at 730 pm today evening	Found
Remind me tomorrow about buying pen for taran with bill. At 9 am.	Found
Remind me to go to dad's shop @ 2:30 pm	Found
Tomo evening at 4.30 pm remember me i should go to near basavana bhavan	Found
remind me to watch baar bar dekho at 8.00 pm today	Found
Hello, when did I ask for this reminder?	Found
Please remind me to do payment of credit card today at 10:10 am	Found
i need a reminder in tamil	Found
please remind me to open crystals at 1655 hours	Found
Via call?	Not Found
Edit my reminder	Found
Remind me in 12:50pm	Found
Add some more reminders	Found
Remind me to book tickets today	Found
I want to remind to my wife birthday	Found
i will stopped reminder...	Found
Alert tone?	Not Found
Set me a reminder after 12 minutes	Found
Can u remind me every day that i have punch in at zinger at 9:45 am ??	Found
Ya sure you can	Not Found
Everyday	Not Found
If my provided number will be out of reach den plz make me a call on 8804033000	Found
Set Alarm from 10:400AM to 10:50AM, today, 2 minutes difference	Found
Also remind me to book ticket of partha on 3rd Jan at 09:30	Found
Add a reminder on 24th nov at 3.30 at meet Mr. Oak	Found
And remind me to check mi store	Found
How can i set reminders	Found
I want to change my child name from kanishk to kanishk lodha in birth certificate tell me procedure for Tamil nadu Chennai Wat is easiest way	Found
Please call.me on 10 Nov, 2016 at 11 am IST please	Found
Give a cll to me at 4pm today to remind me to buy smthing	Found
Any upcoming events?	Not Found
remind me 9pm	Found
Hi, please remind me tomorrow to go to parlour for my eyebrows done.ok	Found
Today I have set a reminder at morning 9 am	Found
Thank u for remember me	Not Found
My reminder came late	Found
Does haptik send me reminders from a single mobile number?	Found
But call on above mention number just said recharge	Found
Remind me to buy eggs at 6 pm today	Found
My reminder of march 18th 2017	Found
Cud u make it hydrating reminder frequency by hour	Found
I want to set it as yearly reminder	Found
Thanks man...i ll let you know in case of any assistance	Not Found
K thks remember with me	Found
I said except on sunday I need a daily alarm at 7:05 AM	Found
Remind me to collect headpone today at 5pm	Found
Plz remind me to eat something at 7pm	Found
Please dismiss all my reminders	Found
Remind me today at 8:00 pm to make note	Found
Can I set reminder for another phone from this phone?	Found
Remind on Monday to call Vivin at 11 am	Found
I also need a general reminder to upload the documents at 11.30 am	Found
Please remind me that I have a flight from Chandigarh to Pune tomorrow at 1430 hours	Found
Change the frequency of reminder	Found
Alarm same time this morning please?	Found
Can you remind me whenever JEE and Gujcet exam online application starts??	Found
Whats that reminder for	Not Found
Remind me at 4:20 pm	Found
Reminders for every month	Not Found
Tell me about best and safe file sharing app	Found
Pls remind for go to garden at 430pm	Found
Please do setup reminder	Found
Surely,Thanks. The same will be for the Language Reminder too?	Found
How could uhh remind me	Found
Second d reminder today 830 pm for the same	Found
Remind for RO service	Found
Call me immediately	Not Found
Pls remind on 7th Jan 2017 at 11am for filling hallticket of nmis	Found
Remind me for purchase of pillows at 5 pm today	Not Found
Ok can you schedule the same task for 2:45 pm today	Found
Every Saturday at 9 pm	Found
I need a reminder	Found
Reminder on another number	Found
Remind me about Lenskart	Not Found
Phone call	Not Found
Will u plz set a reminder for me	Not Found
I need a reminder after 56 days	Found
Please remind me morrow at 5.15	Found
Remind me at 4 pm to visit ICICI Bank and boxer	Found
Can you remind me to do the same after an hour please?	Found
Does my phone need to be connected to Internet for reminders?	Found
Set an alarm for 9 am today	Found
Give a reminder to carry laptop	Found
And remind me to do on every Monday to yuvakender at 9:25pm	Found
Set one more reminder for tonight 930pm	Found
How will I get a reminder?	Found
can you remaind me to sleep at 10.35pm today	Found
Remind me to submit my taxes and pay the man all my money at 12:24	Found
Remind me to go to david sassoon library at 1.30	Found
I wwant to make one more reminder	Found
Remind me to take interview of Pooja on 7th Dec at 8 P. M.	Found
Remind me to get true copy of agreement tomorrow	Found
Remind me on 7 January for visit to borivali for Nagaur got at 3 pm	Found
Call me on	Found
Please remind me the above	Found
Can you remind me to book ticket's for dec end tomorrow ??	Not Found
Thanks for reminder.......	Found
Need repeat alarm in next 5 min	Found
Remind me to follow up with nana at 7 pm today.	Found
Call me in 7898117441	Not Found
I want a reminder to go to Aziza at 4pm	Found
Remind me this at 11 am	Found
Please remind me on 3rd dec 2016... to deactivate active fitness pkg	Found
Remind me at four thorty to check the cookies	Found
Remind me at 3:10 pm today	Found
Please remind me after 15 minutes for food	Found
Can you set reminder for 18 December at 9 pm to book tickets for nations street food festival 2016	Found
U can remind till 10	Found
This reminder for Shivani pathak okk????	Found
Set an alarm at 8 am for tomorrow	Found
Yes komal go ahead	Not Found
again call me after 10 minutes	Found
Yeah thanks for reminding me	Found
Was the call made by you at 12?	Found
Please schedule it for everyday	Found
Nahi 9:15 Ko Mujhe Remind Karo	Found
Remind me that I have math tuition at 2:00pm	Found
Also, remind on Monday thrice	Found
Remind me on 16 Dec at 5 pm for bday of vikas	Found
I want this reminder daily	Found
Please remind me tomorrow at 1pm to mail my leave application	Found
Remind me to cal ravi kumar	Found
Remind me at 5pm to go veer hosiery	Found
Reminder for electrochemical analysis today 11:30 am	Found
Make it for 10:30 am to call Jaineel	Not Found
OBC loan payment. Remind me each month on 28th at 10:30	Found
Thanks for remind me	Found
Just tell me how this remainder option works?	Found
31st Dec 6:45 am 7:00 am 7:10 am Will you schedule all of these please?ðŸ˜ŒðŸ˜Œ	Found
Reminder for roll num attest tomorrow at 10 am	Found
Remind me to book movie tickets today at 12pm	Found
Need to keep reminder	Found
16/1/2016 please remind about court in the morning 8am	Found
I need a reminder at 5.50 pm sharp.	Found
9824671888	Not Found
Remind me for pollution check on 10/03/17at 8.45	Found
reminder on friday at 9 am	Found
If I uninstall haptic will I get reminders?	Found
thanks fr d reminder	Found
Please remind me for paying online for movie tickets	Found
Remind me to eat tablets	Found
Remind me my match	Found
One more birthday remainder please	Found
Could tell me about taj mahal	Found
Remind me at 10 o'clock tomorrow	Found
Will you remind me i have to watch movie?	Not Found
Why are nt you calling me	Found
9811027464	Not Found
Please set a general reminder for today @ 5:00 p.m.	Found
Call me at 8 plZ	Found
Remind me at 10 15 am everyday	Found
That's good service, can you send format of to do list ? Or how to prepare to do list ???	Found
Remind me for shoes g wing and wholesale t & c at 1 pm today and tomorrow both	Found
On this 8th and 9th I arrange a meeting with military staff so please remind me at 9:30 am on those day	Found
I wanted to set on more alarm	Found
21 Nov call to Jaini for Jmd var on 10am	Found
Can u Mee what was today's reminders of me	Found
Can u send automated message(scheduled) to any number	Found
Schedule reminder at 3:10pm today for cheque issue	Found
I need a reminder at 11.55 pm January 6th	Found
Why there isn't any sound for reminding messages?	Found
Please remind me on :720 am	Found
Hi I need 3 reminders a day 1. 11.30 am for salad 2. 1.30 pm for lunch 3. 4 pm for fruits	Found
Pls remind me...Tomorrow I have to submit Power quality analysis report hard copy...	Not Found
Remaind me at 11.59 am yaa	Found
Ty for all the reminders	Found
Put a reminder for me	Found
Remind me to bring atta from chakki today at 9.30pm	Found
Hey, can you remind me to carry my laptop tomorrow morning?	Found
Can you remind me on my nu.mber 9269504000	Found
Remind me to have a walk for every one hour in between 10 - 6pm	Found
Yes thx want reminder daily	Found
Can u Remind me on buying gifts tomorrow for a contest at office may be around at 10:30 am tomorrow	Found
Plz remind m after 5 min	Found
Can u setup one reminder as well	Found
Hi Daniel...remind me to take Airtel connection	Found
that reminder ws 12.30 pm	Found
Remind me to carry make up box	Found
Thnqq for reminding me	Not Found
Call to 2ic tomorrow at 10.30 am	Found
Why arw you calling me.	Not Found
Yes.	Not Found
Reminder to pay insurance premium	Found
Remind me Raheja Plaza hearing on 11-1-17 @ 12-30pm	Found
Guys, inspite my repeated request you all are still sending me these useless reminders , what you want ? Should I downgrade your rating of your app or uninstall permanently.? Next reminder & I will do both thing so beware ðŸ‘¿ðŸ‘¿	Found
Set a reminder in 18th	Found
Remind me according to glasses	Found
Remind me at 9am in the morning to change the order to 100kg each	Found
I did get reminder	Found
One reminder for 9th November 00.00 am	Not Found
9829210008	Not Found
Remind me on Monday about tax submission by 3 pm	Found
This was such a small alarm	Found
All done madam.. thanks.. fortunately I remembered this	Found
Can u please remind me to bring my laptop to college on Tuesday	Found
Remind me to have lunch at 2:30 pm today	Found
Thank u lot for remembering I really appreciate this service	Found
Remind me to take my cheque book and bring it to office tomorrow	Found
Hi.. I need reminder for folic acid only on Wednesdays.. Thanks	Found
Please remind me to visit Bsnl office on Monday 07.11.2016 at 13:30 pm	Found
Reminder at 6	Found
Want to set one reminder	Found
Oh s	Not Found
Reminder to punch in biometry	Found
Cool thanku soo much.... can u send me this msg detail along with a call that day?	Found
Remind me of a flight to Germany on 13th at 11 am	Found
Please remind me to get the printout for a manual today at 7.30pm	Found
Schedule this for tomorrow	Not Found
I will let you know	Not Found
Afterwards	Not Found
Can you remind me to take deo on 24 th November at 4.45 pm	Found
Sure thanks for reminding	Found
Reminder message should be	Found
Can you remind me through phone alert?	Found
7 am	Not Found
I want to remember a birthday	Found
Dont't reminder me for every 30 minutes	Found
Remind me for my cousin bday. At 23:50	Found
Pls remind me on same task at 9 pm	Found
Pls set to 10 am to 6 pm only	Found
Reminder: management hour at 7:45pm today	Found
Can you set a reminder for me	Not Found
I should be able to make conference calls from my mobile. Can you help?	Found
Remind me to remind Rutu about training	Found
Please remember me I have to buy a CD to tomorrow at 5 p.m.	Found
Call me at 12 45 pm	Found
Thanks..	Found
Thanks for the reminder, I had now	Found
If u remind me to study, then it will be much appreciated :p	Found
Will i get my 6:30 pm call	Found
Where is my call	Found
Hey sayali can you please remind me bring photo to college	Found
Hi can I send reminders to my colleagues as well	Found
This Sunday.. Got a meeting with subesh sir. Schedule Tht for me please	Found
Remind me to book a cab at 6 o clock	Found
Good morning shreya	Found
Tell me something about Amazon	Not Found
Today at 12	Found
I need 2 calls one fr 7.00 am n another for 7.30 am	Found
Make me remind tomorrow	Not Found
Keep remaining me about creating my own software for my company for this two weeks. From morning 10am to 6 pm every 2hours once.	Found
Set reminder for 1:30 as i have to study bst	Found
Thanks a lot to remind me	Found
Reminder for getting party games organzined	Found
Pls set a alarm for 8 Am	Not Found
Call me at 9 am	Not Found
Will u remind me daily	Not Found
Where is aspirin reminder?	Found
Pleaze remind me to download the gs notes today 9:30 Pm	Found
Cud u plz set a reminder for me	Not Found
Remind me to have sex at 8pm	Found
Can you change my time 2 reminder of 10am to 10pm?	Found
But I ddnt get a cl from ur side for this reminder	Found
Remind me to take a haircut on the 25th at 6pm	Found
Gayathri 03/01/17 5.10	Found
Does the phone have to be on to get the reminder	Found
Yes.. You can remind me every day	Not Found
Can you please set this up	Found
Can u pls remind me to make a list for all rip and repair styles in one folder	Found
To which number you call?	Not Found
Reminder for journey	Found
One more reminder at 11 am tomorrow to collect post office 5 year term deposit.	Found
Hi .... please remind me to buy deo, pet food, nd grocery	Found
Nopes i want you guys to make that call	Not Found
Like movie tickets , cabs ,etc. There must be another option. Like person assistance. Just a suggestion . Think about it.	Found
Tomorrow poshan ahar meeting place reminder me at 9 am	Found
Remind me about my daughters pajama party on 16.12.16	Found
Make it a schedule for all week days	Not Found
Can u Plz remind me to collect a frame @ 5	Found
One more reminder for s for tomo at 9.30 am	Found
Remind me about Aadhar card	Not Found
Remind Saloni about Stacy courier on 29th November 2016 at 11am	Found
Set the alarm for 8am everyday	Found
Every month of 20th I need remainder	Not Found
Set reminder at 2:30 pm To note down the result of aldol condensation	Found
Remind me to hear kal ho na ho song on jan 7 at 3pm	Found
Yes remind me every monday to friday	Found
Remind me to Go for police verification	Not Found
Also schedule the same for 7am and 7:30am too	Found
Thnaks	Found
Thanks neha. So nice of u	Found
didi can u stp all my reminders plz	Found
Remind me at 15.25 to go to meeting	Found
Remind me to leave for Vaishali at 4 pm today	Found
Please set the alarm for me at 9 clock sharp tomrow	Found
Remind messaginf Geet for blazer and nehru jacket at 10.30pm today.	Not Found
Can you set 2 alarms please?	Not Found
I need that reminder daily	Found
I want you to remind me on 02472222987	Not Found
Two reminders these are	Found
Yes make me remind ....I have onenyt stand with my gf tonight ..plz make me remember at 9	Found
My paper is on 19nov 2016 Time 10am Remind me weather I talk my admit card , photo copy and proof of photo identity	Found
Pls make continues reminder	Found
Please remind me on 19th Jan about Chitra nakshtra	Found
Want to set reminder for milk every day 5.30 PM.	Found
Remember me to study	Found
Please remind me to buy meftal spa in the morning. At around 8.30 am and again remind me at 9 am.	Found
Remind me to pick a bag from friend home	Found
Remind me to Upload money back challenge report tomorrow morning	Found
